"                        ",
"                        ",
" [[[[[[[  [[[[[[[       ",
" [£™™££[  [£™™™™[       ",
" [™™™™£[  [£££™™[       ",
" [™™™£™[[[[£™™££[       ",
" [£™™£££™™£™™™™™[       ",
" [™£££™££™££™™™™[       ",
" [™££™™™™£™££™££[       ",
" [£™™™™™™£™£™™£™[       ",
" [£™£™™™£££™™£™£[[[[[   ",
" [™££££™££™™™™™™™££™[   ",
" [™££™™™™™™™™™™££™™™[   ",
" [£™™™™™™££™™£££™™™™[   ",
" [[[[[[[[[[[[[[[[[[[[   ",
"                        ",
"                        ",
"                        ",
"                        ",
"                        ",
"                        ",
"                        ",
"                        ",
"                        "
